; W1-01 第一步 / First Step
; Author: Official
; Difficulty: 1
; Concept: 单箱推一步即胜，引入"目标点"概念
########
#      #
# @$.  #
#      #
########
