; W1-02 转弯 / Around the Corner
; Author: Official
; Difficulty: 1
; Concept: 玩家需绕到箱子另一侧再推
##########
#        #
#  .     #
#  $     #
#  @     #
#        #
##########
