; W1-03 双子 / Twins
; Author: Official
; Difficulty: 1
; Concept: 引入"多箱"概念，独立推送两个箱子
###########
#         #
#  $   .  #
#         #
#  @      #
#         #
#  $   .  #
#         #
###########
