; W1-05 角落陷阱 / Corner Trap
; Author: Official
; Difficulty: 2
; Concept: 教学"避免把箱子推进角落"——只有一个正确推法
###########
#.        #
#         #
#    $    #
#    @    #
#         #
#         #
###########
