; 关卡草图空白模板（XSB 格式）
; 用法：
;   1. 复制本文件，重命名为 wN-NN.xsb
;   2. 在下方 ASCII 网格中绘制
;   3. 用游戏内编辑器导入此 XSB → 求解验证 → 导出 JSON
;
; 字符表：
;   #  墙        (空格) 地板        .  目标点
;   $  箱子      *  箱子在目标点    @  玩家       +  玩家在目标点
;
; 元数据（注释，导入时被解析为提示，不入正式 metadata）：
; Title: 我的关卡
; Author: 你的名字
; Difficulty: 1
;
; ↓ 在下方编辑（外围务必闭合）

##########
#        #
#   @    #
#  $.    #
#        #
##########
